A	AH
A(2)	EY
ALBUM	AE L B AH M
ALPHA	AE L F AH
AMERICA	AH M EH R IH K AH
ARTIST	AA R T AH S T
ARTIST(2)	AA R T IH S T
AUSTRALIA	AO S T R EY L Y AH
AVA	EY V AH
BATMAN	B AE T M AE N
BRITAIN	B R IH T AH N
COMPUTER	K AH M P Y UW T ER
CONSTANTIN	K AH N S T AE N T IH N
DARTH	D AA R TH
DATE	D EY T
DOES	D AH Z
DOES(2)	D IH Z
EIGTH	EY G TH
ELEVEN	IH L EH V AH N
ELEVEN(2)	IY L EH V AH N
FIVE	F AY V
FOUR	F AO R
FRANCE	F R AE N S
GERMANY	JH ER M AH N IY
GREAT	G R EY T
HAN	HH AA N
HAN(2)	HH AE N
HAVE	HH AE V
HOW	HH AW
INHABITANS	IH N HH AE B AH T AH N Z
IS	IH Z
IT	IH T
KEVIN	K EH V IH N
LUKE	L UW K
MANY	M EH N IY
NINE	N AY N
OF	AH V
ONE	W AH N
ONE(2)	HH W AH N
PI	P AY
PRESIDENT	P R EH Z IH D AH N T
SAY	S EY
SEARCH	S ER CH
SEVEN	S EH V AH N
SIX	S IH K S
SKYWALKER	S K AY W AO K ER
SOLO	S OW L OW
SOMETHING	S AH M TH IH NG
SONG	S AO NG
SPOTIFY	S P AA T AH F AY
STATES	S T EY T S
TEN	T EH N
THE	DH AH
THE(2)	DH IY
THREE	TH R IY
TWELVE	T W EH L V
TWO	T UW
UNITED	Y UW N AY T AH D
UNITED(2)	Y UW N AY T IH D
VADER	V EY D ER
WHAT	W AH T
WHAT(2)	HH W AH T
WHO	HH UW
WOLFRAM	W UH L F R AE M
YODA	Y OW D AH
